  NO ./pics/redbrick.xpm
SO ./pics/eagle.xpm
WE ./pics/bluestone.xpm

EA ./pics/wood.xpm

F      17,    38,       0

C 218, 234, 235

          111111111111111
111111111110000000E0001
1000000000000011111111111
100000100000001
100000000000001
100000010000001
100001000000001
100000000000001
100000000000001
111111111111111