  NO ./pics/redbrick.xpm
SO ./pics/eagle.xpm
WE ./pics/bluestone.xpm

EA ./pics/wood.xpm

F      17,    38,       0

C 218, 234, 235

           1111111111111
 111111111100000000000001
100000000000001111111111
100000100000001
100000000000001
100001111000001
100010000000001
100010N00100001
100001111000001
 111111111111

            1111111111111
 111111111100000000000001
100000000000001111111111
100000100000001
100000000000001
100001111000001
100010000000001
100010W00100001
100001111000001
 1111111111111                   11110000001111
