NO ./pics/redbrick.xpm
SO ./pics/eagle.xpm
WE ./pics/bluestone.xpm

EA ./pics/wood.xpm
F 210,-1,0

C 225,258,0

          111111111111111
1111111111100000000E00001
1000000000000011111111111
100000100000001
100000000000001
100000010000001
100001000000001
100000000000001
100000000000001
111111111111111
