  NO ./pics/redbrick.xpm
SO ./pics/eagle.xpm
WE ./pics/bluestone.xpm

EA ./pics/wood.xpm

F      17,    38,       0

C 218, 234, 235

           1111111111111
11111111111S000000000001
100000000000001111111111
100000100000001
100000000000001
100001111000001
100010000000001
100010001000011
100001111000001
111111111111111